NO texture/wall_1.xpm
SO texture/wall_2.xpm
WE texture/wall_3.xpm
EA texture/wall_4.xpm

F 0,0,0
C 41,117,119

        11111111111111111111111111111111111
        11000000000000000000000000000000011
        110000000000000000000000000000000111111111111
        110011111111111111111111111111000000000000011
        1100111111111111111111111111111100000000000011
        11001111111111111111111111111111111111111000011
        110011111111111111111111111111111111111111100011
        111000111111111111111111111111111111111110000111
111111111111100001111111111111111111111111111111000011
11000000110000001111111111111111111111111111111100011
1000110000011111111111111111111111111111111111110001111
1000111111111111111111111111111111111111111111111000011
1000111111111111111111111111111111111111111111100000111
110001111111111111111111111111111111111111111100001111
1100000000011111111111111111111111111111111111100011
11111100000000000000000000000000E000000000000000011
111111111000000000000000000000000000000000000000111
111111111111111111111111111111111111111111111111111
